######
#S==E#
##=###
#=####
#====#
######